111111111111111111111
100100C0000C000000001
1E000P1110000C0000001
1111100000C0001010001
100C00001000010000001
1C11100000000110000C1
111111111111111111111
